
Словарь - Модуль 4
border - граница
solid - граница сплошной линией
dotted - граница не сплошной линией, а через точку
dashed - граница не сплошной линией, а через тире
margin - отступ
margin-left - отступ от левого поля
margin-right - отступ от правого поля
margin-top - отступ от верхнего поля
margin-bottom - отступ от нижнего поля
indentation - оформление кода с точки зрения отступов внутри. На работу кода это не
влияет, но создает ощущение чистоты и опрятности.
icon/favicon - иконка
div - тег-контейнер (он может в себя включать другие элементы).
Например, тег <p> не может в себя ничего включать, кроме текста, а вот тег <div>
может в себя включать и изображения, и заголовки, и абзацы. Он в такой роли сразу
становится родителем.
id selector - селектор айди. Очень похож на селетор классов, но может быть
использован только 1 раз на странице (пример: тег h1). В CSS его пишем через #.
padding - набивка
Через эту команду мы набиваем элемент пространством
button - кнопка
hover - наведение мышки на слово
transition-duration: 5s; - сколько в секундах длится изменение (например, цвета
кнопки).
cursor - что случается при наведении курсора на кнопку.
Могут быть такие команды, как wait, help, crosshair, pointer и так далее). Мы
рассмотрели в уроках, что делают эти команды.
font - шрифт
font-family - семья шрифта
